npcname_JP.	農夫
npcname_EN.	farmer
numflavor_passiveJP.	0
numflavor_passiveEN.	0
numflavor_angeredJP.	2
numflavor_angeredEN.	0
flavorangered_JP.0	「なにするだー」
flavorangered_JP.1	「やめるだー」
numflavor_deathJP.	4
numflavor_deathEN.	0
flavordeath_JP.0	「おらは…おらはー！」
flavordeath_JP.1	「田舎モンだからって…！」
flavordeath_JP.2	「食べ物を粗末にするな！」
flavordeath_JP.3	「はぐわ」
numflavor_killJP.	1
numflavor_killEN.	1
flavorkill_JP.0	「よわいべ」
flavorkill_EN.0	"Weak!"
numflavor_welcomeJP.	0
numflavor_welcomeEN.	0
