npcname_JP.	魔術士ギルドマスター『レヴラス』
npcname_EN.	<Revlus> the mage guildmaster
numflavor_passiveJP.	3
numflavor_passiveEN.	3
flavorpassive_JP.0	魔法を詠唱する声が聞こえる。
flavorpassive_JP.1	辺りはピリピリとした緊張で包まれている。
flavorpassive_JP.2	部屋全体に魔力の波がただよっている。
flavorpassive_EN.0	"Magic is not for the faint of heart, nor dull of mind."
flavorpassive_EN.1	You hear chants for spells you can't even begin to imagine the purpose of
flavorpassive_EN.2	A pulse of arcane and raw eldritch energies nearly knocks you off your feet
numflavor_angeredJP.	1
numflavor_angeredEN.	0
flavorangered_JP.0	「口で言っても無駄のようですね」
numflavor_deathJP.	1
numflavor_deathEN.	0
flavordeath_JP.0	「そ、そんなはずはないのです！」
numflavor_killJP.	1
numflavor_killEN.	0
flavorkill_JP.0	「みなさん、新たな献体が手に入りましたよ」
numflavor_welcomeJP.	0
numflavor_welcomeEN.	0
