npcname_JP.	白金ガチョウ
npcname_EN.	goose
numflavor_passiveJP.	3
numflavor_passiveEN.	0
flavorpassive_JP.0	 *ばさばさ*
flavorpassive_JP.1	「ぐわッ」
flavorpassive_JP.2	 「ぐわぐわ」
numflavor_angeredJP.	2
numflavor_angeredEN.	0
flavorangered_JP.0	「ぐぐわッ！」
flavorangered_JP.1	「ぐわ！」
numflavor_deathJP.	2
numflavor_deathEN.	0
flavordeath_JP.0	地面に白い羽が散らばった。
flavordeath_JP.1	「がちょーん」
numflavor_killJP.	1
numflavor_killEN.	0
flavorkill_JP.0	「ぐわッぐッぐぐ！」
numflavor_welcomeJP.	0
numflavor_welcomeEN.	0
